##########
#........#
#.######.#
#.#....#.#
#.#.##.#.#
#.#.#..#.#
#S#.#.##.#
#...##...#
#.#####G.#
##########